################################################# 
# #    #      #                                 # 
# #    #  #####                                 # 
# #    #  #                                     # 
# #    #  #                                     # 
# ######  ######################                # 
#      O                    X  #                # 
# ####### #################### ###########      # 
# #     # #                  #           #      # 
# #     # #################  ########### #      # 
# #     #                              # ######## 
# ###################################  #        # 
#                           ###     #  #        # 
# ########################  ###     #  #        # 
# ########################  ###     #  ####     # 
#                                               # 
#################################################