#################################################
#            #  L                               #
#    O       #####                              #
#                                               #
############                                    #
#          #                                    #
#          #                                    #
#          #                                    #
#                                               #
#                                               #
#                                               #
#                                               #
#                                               #
#                                               #
#                                               #
#                                               #
#################################################