#################################################
#X#         L                                   #
# #                                             #
# #                                             #
#O#                                             #
# #######                                       #
#                                               #
# ####### #                                     #
# #     # #                                     #
# #     # #############                         #
# #     #                                       #
# #     ###############                         #
# #                                             #
# #                                             #
# #############                                 #
#                                               #
#################################################