#################################################
# #    #      #                                 #
# #    #  #####                                 #
# #    #  #                                     #
#O#    #  #                                     #
# ######  ######################                #
#                           X  #                #
# ####### #################### ###########      #
# #     # #                  #           #      #
# #     # #################  ########### #      #
# #     #                              # ########
# ###################################  #        #
#                           ###     #  #        #
# ########################  ###     #  #        #
# ########################  ###     #  ####     #
#                                            L  #
#################################################